/* ************************************************************************** */
/*                                                                            */
/*                                                        :::      ::::::::   */
/*   max.c                                              :+:      :+:    :+:   */
/*                                                    +:+ +:+         +:+     */
/*   By: fnilsson <marvin@42.fr>                    +#+  +:+       +#+        */
/*                                                +#+#+#+#+#+   +#+           */
/*   Created: 2018/07/12 16:42:54 by fnilsson          #+#    #+#             */
/*   Updated: 2018/07/12 16:55:21 by fnilsson         ###   ########.fr       */
/*                                                                            */
/* ************************************************************************** */

int     max(int* tab, unsigned int len);
{
	
}
